team,date,count,win,loss,cur_count,cur_win,cur_loss
POR,2001-11-04,4,1,3,4,1,3
POR,2001-11-11,8,4,4,4,3,1
POR,2001-11-18,11,6,5,3,2,1
POR,2001-11-25,14,7,7,3,1,2
POR,2001-12-02,17,9,8,3,2,1
POR,2001-12-09,19,10,9,2,1,1
POR,2001-12-16,22,11,11,3,1,2
POR,2001-12-23,26,13,13,4,2,2
POR,2001-12-30,29,13,16,3,0,3
POR,2002-01-06,32,14,18,3,1,2
POR,2002-01-13,37,18,19,5,4,1
POR,2002-01-20,40,20,20,3,2,1
POR,2002-01-27,42,22,20,2,2,0
POR,2002-02-03,46,25,21,4,3,1
POR,2002-02-17,51,27,24,5,2,3
POR,2002-02-24,55,31,24,4,4,0
POR,2002-03-03,59,35,24,4,4,0
POR,2002-03-10,63,38,25,4,3,1
POR,2002-03-17,65,40,25,2,2,0
POR,2002-03-24,69,43,26,4,3,1
POR,2002-03-31,73,44,29,4,1,3
POR,2002-04-07,82,49,33,9,5,4
NJN,2001-11-04,4,3,1,4,3,1
NJN,2001-11-11,6,5,1,2,2,0
NJN,2001-11-18,9,7,2,3,2,1
NJN,2001-11-25,14,9,5,5,2,3
NJN,2001-12-02,16,10,6,2,1,1
NJN,2001-12-09,19,12,7,3,2,1
NJN,2001-12-16,22,15,7,3,3,0
NJN,2001-12-23,25,16,9,3,1,2
NJN,2001-12-30,28,19,9,3,3,0
NJN,2002-01-06,32,21,11,4,2,2
NJN,2002-01-13,35,24,11,3,3,0
NJN,2002-01-20,39,27,12,4,3,1
NJN,2002-01-27,43,29,14,4,2,2
NJN,2002-02-03,45,31,14,2,2,0
NJN,2002-02-17,51,34,17,6,3,3
NJN,2002-02-24,55,38,17,4,4,0
NJN,2002-03-03,58,39,19,3,1,2
NJN,2002-03-10,62,39,23,4,0,4
NJN,2002-03-17,66,42,24,4,3,1
NJN,2002-03-24,70,45,25,4,3,1
NJN,2002-03-31,74,47,27,4,2,2
NJN,2002-04-07,82,52,30,8,5,3
SAS,2001-11-04,4,2,2,4,2,2
SAS,2001-11-11,7,5,2,3,3,0
SAS,2001-11-18,9,7,2,2,2,0
SAS,2001-11-25,12,9,3,3,2,1
SAS,2001-12-02,15,11,4,3,2,1
SAS,2001-12-09,18,14,4,3,3,0
SAS,2001-12-16,21,17,4,3,3,0
SAS,2001-12-23,25,20,5,4,3,1
SAS,2001-12-30,28,21,7,3,1,2
SAS,2002-01-06,31,23,8,3,2,1
SAS,2002-01-13,34,25,9,3,2,1
SAS,2002-01-20,38,27,11,4,2,2
SAS,2002-01-27,42,29,13,4,2,2
SAS,2002-02-03,46,30,16,4,1,3
SAS,2002-02-17,51,33,18,5,3,2
SAS,2002-02-24,55,35,20,4,2,2
SAS,2002-03-03,59,38,21,4,3,1
SAS,2002-03-10,62,41,21,3,3,0
SAS,2002-03-17,66,45,21,4,4,0
SAS,2002-03-24,69,48,21,3,3,0
SAS,2002-03-31,73,49,24,4,1,3
SAS,2002-04-07,82,58,24,9,9,0
SEA,2001-11-04,3,1,2,3,1,2
SEA,2001-11-11,8,3,5,5,2,3
SEA,2001-11-18,11,4,7,3,1,2
SEA,2001-11-25,15,7,8,4,3,1
SEA,2001-12-02,19,9,10,4,2,2
SEA,2001-12-09,23,9,14,4,0,4
SEA,2001-12-16,26,11,15,3,2,1
SEA,2001-12-23,29,14,15,3,3,0
SEA,2001-12-30,31,16,15,2,2,0
SEA,2002-01-06,33,17,16,2,1,1
SEA,2002-01-13,36,19,17,3,2,1
SEA,2002-01-20,39,20,19,3,1,2
SEA,2002-01-27,43,23,20,4,3,1
SEA,2002-02-03,46,23,23,3,0,3
SEA,2002-02-17,52,27,25,6,4,2
SEA,2002-02-24,56,30,26,4,3,1
SEA,2002-03-03,60,33,27,4,3,1
SEA,2002-03-10,63,36,27,3,3,0
SEA,2002-03-17,67,37,30,4,1,3
SEA,2002-03-24,70,39,31,3,2,1
SEA,2002-03-31,74,43,31,4,4,0
SEA,2002-04-07,82,45,37,8,2,6
MIA,2001-11-04,3,1,2,3,1,2
MIA,2001-11-11,6,2,4,3,1,2
MIA,2001-11-18,9,2,7,3,0,3
MIA,2001-11-25,12,2,10,3,0,3
MIA,2001-12-02,15,2,13,3,0,3
MIA,2001-12-09,18,3,15,3,1,2
MIA,2001-12-16,22,5,17,4,2,2
MIA,2001-12-23,25,5,20,3,0,3
MIA,2001-12-30,28,5,23,3,0,3
MIA,2002-01-06,31,8,23,3,3,0
MIA,2002-01-13,34,8,26,3,0,3
MIA,2002-01-20,38,12,26,4,4,0
MIA,2002-01-27,42,15,27,4,3,1
MIA,2002-02-03,46,18,28,4,3,1
MIA,2002-02-17,50,20,30,4,2,2
MIA,2002-02-24,54,23,31,4,3,1
MIA,2002-03-03,57,25,32,3,2,1
MIA,2002-03-10,61,28,33,4,3,1
MIA,2002-03-17,64,30,34,3,2,1
MIA,2002-03-24,68,31,37,4,1,3
MIA,2002-03-31,72,32,40,4,1,3
MIA,2002-04-07,82,36,46,10,4,6
DET,2001-11-04,4,3,1,4,3,1
DET,2001-11-11,6,4,2,2,1,1
DET,2001-11-18,8,6,2,2,2,0
DET,2001-11-25,12,8,4,4,2,2
DET,2001-12-02,16,11,5,4,3,1
DET,2001-12-09,19,13,6,3,2,1
DET,2001-12-16,21,14,7,2,1,1
DET,2001-12-23,25,14,11,4,0,4
DET,2001-12-30,28,15,13,3,1,2
DET,2002-01-06,31,16,15,3,1,2
DET,2002-01-13,35,17,18,4,1,3
DET,2002-01-20,38,19,19,3,2,1
DET,2002-01-27,41,21,20,3,2,1
DET,2002-02-03,45,24,21,4,3,1
DET,2002-02-17,50,28,22,5,4,1
DET,2002-02-24,54,31,23,4,3,1
DET,2002-03-03,57,34,23,3,3,0
DET,2002-03-10,61,35,26,4,1,3
DET,2002-03-17,64,37,27,3,2,1
DET,2002-03-24,69,41,28,5,4,1
DET,2002-03-31,73,44,29,4,3,1
DET,2002-04-07,82,50,32,9,6,3
CHH,2001-11-04,3,2,1,3,2,1
CHH,2001-11-11,6,3,3,3,1,2
CHH,2001-11-18,9,4,5,3,1,2
CHH,2001-11-25,13,6,7,4,2,2
CHH,2001-12-02,16,7,9,3,1,2
CHH,2001-12-09,20,9,11,4,2,2
CHH,2001-12-16,23,11,12,3,2,1
CHH,2001-12-23,27,12,15,4,1,3
CHH,2001-12-30,30,13,17,3,1,2
CHH,2002-01-06,32,14,18,2,1,1
CHH,2002-01-13,36,17,19,4,3,1
CHH,2002-01-20,39,18,21,3,1,2
CHH,2002-01-27,43,20,23,4,2,2
CHH,2002-02-03,46,23,23,3,3,0
CHH,2002-02-17,51,25,26,5,2,3
CHH,2002-02-24,55,27,28,4,2,2
CHH,2002-03-03,59,29,30,4,2,2
CHH,2002-03-10,62,30,32,3,1,2
CHH,2002-03-17,65,32,33,3,2,1
CHH,2002-03-24,69,36,33,4,4,0
CHH,2002-03-31,72,38,34,3,2,1
CHH,2002-04-07,82,44,38,10,6,4
UTA,2001-11-04,4,1,3,4,1,3
UTA,2001-11-11,7,2,5,3,1,2
UTA,2001-11-18,11,4,7,4,2,2
UTA,2001-11-25,13,5,8,2,1,1
UTA,2001-12-02,17,6,11,4,1,3
UTA,2001-12-09,20,9,11,3,3,0
UTA,2001-12-16,24,11,13,4,2,2
UTA,2001-12-23,28,13,15,4,2,2
UTA,2001-12-30,31,16,15,3,3,0
UTA,2002-01-06,33,17,16,2,1,1
UTA,2002-01-13,36,19,17,3,2,1
UTA,2002-01-20,40,21,19,4,2,2
UTA,2002-01-27,44,22,22,4,1,3
UTA,2002-02-03,47,25,22,3,3,0
UTA,2002-02-17,53,29,24,6,4,2
UTA,2002-02-24,55,31,24,2,2,0
UTA,2002-03-03,58,32,26,3,1,2
UTA,2002-03-10,62,34,28,4,2,2
UTA,2002-03-17,66,36,30,4,2,2
UTA,2002-03-24,69,38,31,3,2,1
UTA,2002-03-31,73,41,32,4,3,1
UTA,2002-04-07,82,44,38,9,3,6
TOR,2001-11-04,4,2,2,4,2,2
TOR,2001-11-11,7,4,3,3,2,1
TOR,2001-11-18,11,7,4,4,3,1
TOR,2001-11-25,15,9,6,4,2,2
TOR,2001-12-02,18,11,7,3,2,1
TOR,2001-12-09,21,12,9,3,1,2
TOR,2001-12-16,24,12,12,3,0,3
TOR,2001-12-23,27,15,12,3,3,0
TOR,2001-12-30,30,16,14,3,1,2
TOR,2002-01-06,33,18,15,3,2,1
TOR,2002-01-13,37,20,17,4,2,2
TOR,2002-01-20,41,24,17,4,4,0
TOR,2002-01-27,45,26,19,4,2,2
TOR,2002-02-03,47,27,20,2,1,1
TOR,2002-02-17,54,29,25,7,2,5
TOR,2002-02-24,58,29,29,4,0,4
TOR,2002-03-03,61,29,32,3,0,3
TOR,2002-03-10,65,30,35,4,1,3
TOR,2002-03-17,67,30,37,2,0,2
TOR,2002-03-24,70,32,38,3,2,1
TOR,2002-03-31,73,35,38,3,3,0
TOR,2002-04-07,82,42,40,9,7,2
MIL,2001-11-04,3,3,0,3,3,0
MIL,2001-11-11,5,4,1,2,1,1
MIL,2001-11-18,7,6,1,2,2,0
MIL,2001-11-25,10,9,1,3,3,0
MIL,2001-12-02,14,9,5,4,0,4
MIL,2001-12-09,17,11,6,3,2,1
MIL,2001-12-16,20,13,7,3,2,1
MIL,2001-12-23,24,15,9,4,2,2
MIL,2001-12-30,27,18,9,3,3,0
MIL,2002-01-06,31,18,13,4,0,4
MIL,2002-01-13,34,21,13,3,3,0
MIL,2002-01-20,38,25,13,4,4,0
MIL,2002-01-27,42,26,16,4,1,3
MIL,2002-02-03,45,27,18,3,1,2
MIL,2002-02-17,50,29,21,5,2,3
MIL,2002-02-24,54,32,22,4,3,1
MIL,2002-03-03,58,34,24,4,2,2
MIL,2002-03-10,62,35,27,4,1,3
MIL,2002-03-17,64,36,28,2,1,1
MIL,2002-03-24,68,37,31,4,1,3
MIL,2002-03-31,72,38,34,4,1,3
MIL,2002-04-07,82,41,41,10,3,7
ORL,2001-11-04,3,2,1,3,2,1
ORL,2001-11-11,7,3,4,4,1,3
ORL,2001-11-18,11,5,6,4,2,2
ORL,2001-11-25,14,7,7,3,2,1
ORL,2001-12-02,17,8,9,3,1,2
ORL,2001-12-09,21,11,10,4,3,1
ORL,2001-12-16,26,12,14,5,1,4
ORL,2001-12-23,29,13,16,3,1,2
ORL,2001-12-30,32,15,17,3,2,1
ORL,2002-01-06,35,17,18,3,2,1
ORL,2002-01-13,39,19,20,4,2,2
ORL,2002-01-20,42,21,21,3,2,1
ORL,2002-01-27,45,23,22,3,2,1
ORL,2002-02-03,48,24,24,3,1,2
ORL,2002-02-17,52,27,25,4,3,1
ORL,2002-02-24,55,29,26,3,2,1
ORL,2002-03-03,59,31,28,4,2,2
ORL,2002-03-10,63,33,30,4,2,2
ORL,2002-03-17,66,36,30,3,3,0
ORL,2002-03-24,69,37,32,3,1,2
ORL,2002-03-31,73,40,33,4,3,1
ORL,2002-04-07,82,44,38,9,4,5
IND,2001-11-04,4,2,2,4,2,2
IND,2001-11-11,8,6,2,4,4,0
IND,2001-11-18,12,6,6,4,0,4
IND,2001-11-25,16,8,8,4,2,2
IND,2001-12-02,20,10,10,4,2,2
IND,2001-12-09,23,12,11,3,2,1
IND,2001-12-16,25,13,12,2,1,1
IND,2001-12-23,29,16,13,4,3,1
IND,2001-12-30,32,18,14,3,2,1
IND,2002-01-06,35,20,15,3,2,1
IND,2002-01-13,38,21,17,3,1,2
IND,2002-01-20,42,21,21,4,0,4
IND,2002-01-27,46,23,23,4,2,2
IND,2002-02-03,49,25,24,3,2,1
IND,2002-02-17,53,26,27,4,1,3
IND,2002-02-24,55,27,28,2,1,1
IND,2002-03-03,59,29,30,4,2,2
IND,2002-03-10,63,31,32,4,2,2
IND,2002-03-17,66,34,32,3,3,0
IND,2002-03-24,69,35,34,3,1,2
IND,2002-03-31,72,36,36,3,1,2
IND,2002-04-07,82,42,40,10,6,4
CLE,2001-11-04,4,1,3,4,1,3
CLE,2001-11-11,7,1,6,3,0,3
CLE,2001-11-18,11,2,9,4,1,3
CLE,2001-11-25,14,4,10,3,2,1
CLE,2001-12-02,17,6,11,3,2,1
CLE,2001-12-09,20,8,12,3,2,1
CLE,2001-12-16,23,9,14,3,1,2
CLE,2001-12-23,27,11,16,4,2,2
CLE,2001-12-30,30,12,18,3,1,2
CLE,2002-01-06,33,13,20,3,1,2
CLE,2002-01-13,37,13,24,4,0,4
CLE,2002-01-20,40,13,27,3,0,3
CLE,2002-01-27,43,13,30,3,0,3
CLE,2002-02-03,46,14,32,3,1,2
CLE,2002-02-17,51,18,33,5,4,1
CLE,2002-02-24,55,20,35,4,2,2
CLE,2002-03-03,59,21,38,4,1,3
CLE,2002-03-10,63,23,40,4,2,2
CLE,2002-03-17,66,24,42,3,1,2
CLE,2002-03-24,69,25,44,3,1,2
CLE,2002-03-31,73,25,48,4,0,4
CLE,2002-04-07,82,29,53,9,4,5
ATL,2001-11-04,3,1,2,3,1,2
ATL,2001-11-11,7,1,6,4,0,4
ATL,2001-11-18,10,3,7,3,2,1
ATL,2001-11-25,14,5,9,4,2,2
ATL,2001-12-02,18,6,12,4,1,3
ATL,2001-12-09,21,7,14,3,1,2
ATL,2001-12-16,23,9,14,2,2,0
ATL,2001-12-23,27,10,17,4,1,3
ATL,2001-12-30,30,11,19,3,1,2
ATL,2002-01-06,32,12,20,2,1,1
ATL,2002-01-13,36,13,23,4,1,3
ATL,2002-01-20,39,13,26,3,0,3
ATL,2002-01-27,43,14,29,4,1,3
ATL,2002-02-03,47,15,32,4,1,3
ATL,2002-02-17,52,19,33,5,4,1
ATL,2002-02-24,56,20,36,4,1,3
ATL,2002-03-03,58,21,37,2,1,1
ATL,2002-03-10,61,22,39,3,1,2
ATL,2002-03-17,65,25,40,4,3,1
ATL,2002-03-24,69,28,41,4,3,1
ATL,2002-03-31,73,29,44,4,1,3
ATL,2002-04-07,82,33,49,9,4,5
SAC,2001-11-04,3,3,0,3,3,0
SAC,2001-11-11,7,5,2,4,2,2
SAC,2001-11-18,10,7,3,3,2,1
SAC,2001-11-25,13,10,3,3,3,0
SAC,2001-12-02,18,13,5,5,3,2
SAC,2001-12-09,21,16,5,3,3,0
SAC,2001-12-16,25,18,7,4,2,2
SAC,2001-12-23,29,20,9,4,2,2
SAC,2001-12-30,32,23,9,3,3,0
SAC,2002-01-06,35,26,9,3,3,0
SAC,2002-01-13,36,27,9,1,1,0
SAC,2002-01-20,39,30,9,3,3,0
SAC,2002-01-27,43,33,10,4,3,1
SAC,2002-02-03,46,36,10,3,3,0
SAC,2002-02-17,52,39,13,6,3,3
SAC,2002-02-24,55,40,15,3,1,2
SAC,2002-03-03,58,42,16,3,2,1
SAC,2002-03-10,61,44,17,3,2,1
SAC,2002-03-17,65,47,18,4,3,1
SAC,2002-03-24,68,49,19,3,2,1
SAC,2002-03-31,72,53,19,4,4,0
SAC,2002-04-07,82,61,21,10,8,2
DEN,2001-11-04,3,1,2,3,1,2
DEN,2001-11-11,7,3,4,4,2,2
DEN,2001-11-18,10,5,5,3,2,1
DEN,2001-11-25,14,6,8,4,1,3
DEN,2001-12-02,16,7,9,2,1,1
DEN,2001-12-09,20,7,13,4,0,4
DEN,2001-12-16,23,9,14,3,2,1
DEN,2001-12-23,26,9,17,3,0,3
DEN,2001-12-30,29,10,19,3,1,2
DEN,2002-01-06,31,10,21,2,0,2
DEN,2002-01-13,35,11,24,4,1,3
DEN,2002-01-20,39,12,27,4,1,3
DEN,2002-01-27,42,13,29,3,1,2
DEN,2002-02-03,44,13,31,2,0,2
DEN,2002-02-17,49,16,33,5,3,2
DEN,2002-02-24,53,16,37,4,0,4
DEN,2002-03-03,56,17,39,3,1,2
DEN,2002-03-10,59,19,40,3,2,1
DEN,2002-03-17,63,19,44,4,0,4
DEN,2002-03-24,67,20,47,4,1,3
DEN,2002-03-31,72,22,50,5,2,3
DEN,2002-04-07,82,27,55,10,5,5
BOS,2001-11-04,4,2,2,4,2,2
BOS,2001-11-11,6,4,2,2,2,0
BOS,2001-11-18,8,5,3,2,1,1
BOS,2001-11-25,11,5,6,3,0,3
BOS,2001-12-02,15,9,6,4,4,0
BOS,2001-12-09,18,11,7,3,2,1
BOS,2001-12-16,21,14,7,3,3,0
BOS,2001-12-23,25,17,8,4,3,1
BOS,2001-12-30,29,18,11,4,1,3
BOS,2002-01-06,32,20,12,3,2,1
BOS,2002-01-13,36,22,14,4,2,2
BOS,2002-01-20,39,23,16,3,1,2
BOS,2002-01-27,43,26,17,4,3,1
BOS,2002-02-03,47,27,20,4,1,3
BOS,2002-02-17,53,30,23,6,3,3
BOS,2002-02-24,56,31,25,3,1,2
BOS,2002-03-03,58,31,27,2,0,2
BOS,2002-03-10,62,35,27,4,4,0
BOS,2002-03-17,66,38,28,4,3,1
BOS,2002-03-24,70,39,31,4,1,3
BOS,2002-03-31,74,42,32,4,3,1
BOS,2002-04-07,82,49,33,8,7,1
NYK,2001-11-04,3,1,2,3,1,2
NYK,2001-11-11,7,2,5,4,1,3
NYK,2001-11-18,11,4,7,4,2,2
NYK,2001-11-25,14,6,8,3,2,1
NYK,2001-12-02,17,8,9,3,2,1
NYK,2001-12-09,20,11,9,3,3,0
NYK,2001-12-16,24,11,13,4,0,4
NYK,2001-12-23,27,12,15,3,1,2
NYK,2001-12-30,30,13,17,3,1,2
NYK,2002-01-06,32,14,18,2,1,1
NYK,2002-01-13,36,14,22,4,0,4
NYK,2002-01-20,38,14,24,2,0,2
NYK,2002-01-27,42,17,25,4,3,1
NYK,2002-02-03,45,18,27,3,1,2
NYK,2002-02-17,51,20,31,6,2,4
NYK,2002-02-24,54,20,34,3,0,3
NYK,2002-03-03,57,21,36,3,1,2
NYK,2002-03-10,61,23,38,4,2,2
NYK,2002-03-17,65,25,40,4,2,2
NYK,2002-03-24,68,26,42,3,1,2
NYK,2002-03-31,72,27,45,4,1,3
NYK,2002-04-07,82,30,52,10,3,7
LAL,2001-11-04,4,4,0,4,4,0
LAL,2001-11-11,6,6,0,2,2,0
LAL,2001-11-18,9,8,1,3,2,1
LAL,2001-11-25,13,12,1,4,4,0
LAL,2001-12-02,16,15,1,3,3,0
LAL,2001-12-09,18,16,2,2,1,1
LAL,2001-12-16,21,18,3,3,2,1
LAL,2001-12-23,23,19,4,2,1,1
LAL,2001-12-30,27,21,6,4,2,2
LAL,2002-01-06,30,24,6,3,3,0
LAL,2002-01-13,34,26,8,4,2,2
LAL,2002-01-20,37,28,9,3,2,1
LAL,2002-01-27,41,29,12,4,1,3
LAL,2002-02-03,45,33,12,4,4,0
LAL,2002-02-17,50,35,15,5,2,3
LAL,2002-02-24,54,38,16,4,3,1
LAL,2002-03-03,58,41,17,4,3,1
LAL,2002-03-10,61,43,18,3,2,1
LAL,2002-03-17,65,47,18,4,4,0
LAL,2002-03-24,69,49,20,4,2,2
LAL,2002-03-31,73,52,21,4,3,1
LAL,2002-04-07,82,58,24,9,6,3
PHI,2001-11-04,3,0,3,3,0,3
PHI,2001-11-11,6,1,5,3,1,2
PHI,2001-11-18,10,5,5,4,4,0
PHI,2001-11-25,13,7,6,3,2,1
PHI,2001-12-02,16,8,8,3,1,2
PHI,2001-12-09,20,8,12,4,0,4
PHI,2001-12-16,23,9,14,3,1,2
PHI,2001-12-23,26,11,15,3,2,1
PHI,2001-12-30,30,12,18,4,1,3
PHI,2002-01-06,33,14,19,3,2,1
PHI,2002-01-13,36,16,20,3,2,1
PHI,2002-01-20,39,19,20,3,3,0
PHI,2002-01-27,43,22,21,4,3,1
PHI,2002-02-03,46,24,22,3,2,1
PHI,2002-02-17,51,25,26,5,1,4
PHI,2002-02-24,54,27,27,3,2,1
PHI,2002-03-03,58,30,28,4,3,1
PHI,2002-03-10,62,33,29,4,3,1
PHI,2002-03-17,65,34,31,3,1,2
PHI,2002-03-24,69,37,32,4,3,1
PHI,2002-03-31,73,38,35,4,1,3
PHI,2002-04-07,82,43,39,9,5,4
WAS,2001-11-04,4,2,2,4,2,2
WAS,2001-11-11,7,2,5,3,0,3
WAS,2001-11-18,9,2,7,2,0,2
WAS,2001-11-25,12,3,9,3,1,2
WAS,2001-12-02,16,5,11,4,2,2
WAS,2001-12-09,19,7,12,3,2,1
WAS,2001-12-16,23,11,12,4,4,0
WAS,2001-12-23,26,14,12,3,3,0
WAS,2001-12-30,29,15,14,3,1,2
WAS,2002-01-06,31,17,14,2,2,0
WAS,2002-01-13,34,18,16,3,1,2
WAS,2002-01-20,37,19,18,3,1,2
WAS,2002-01-27,41,21,20,4,2,2
WAS,2002-02-03,45,24,21,4,3,1
WAS,2002-02-17,50,27,23,5,3,2
WAS,2002-02-24,55,27,28,5,0,5
WAS,2002-03-03,58,28,30,3,1,2
WAS,2002-03-10,62,29,33,4,1,3
WAS,2002-03-17,66,30,36,4,1,3
WAS,2002-03-24,70,32,38,4,2,2
WAS,2002-03-31,73,34,39,3,2,1
WAS,2002-04-07,82,37,45,9,3,6
CHI,2001-11-04,3,1,2,3,1,2
CHI,2001-11-11,6,1,5,3,0,3
CHI,2001-11-18,10,1,9,4,0,4
CHI,2001-11-25,12,1,11,2,0,2
CHI,2001-12-02,15,2,13,3,1,2
CHI,2001-12-09,19,4,15,4,2,2
CHI,2001-12-16,22,4,18,3,0,3
CHI,2001-12-23,25,4,21,3,0,3
CHI,2001-12-30,28,5,23,3,1,2
CHI,2002-01-06,32,6,26,4,1,3
CHI,2002-01-13,36,7,29,4,1,3
CHI,2002-01-20,39,8,31,3,1,2
CHI,2002-01-27,42,9,33,3,1,2
CHI,2002-02-03,46,10,36,4,1,3
CHI,2002-02-17,51,12,39,5,2,3
CHI,2002-02-24,55,15,40,4,3,1
CHI,2002-03-03,59,16,43,4,1,3
CHI,2002-03-10,63,16,47,4,0,4
CHI,2002-03-17,67,17,50,4,1,3
CHI,2002-03-24,70,17,53,3,0,3
CHI,2002-03-31,73,17,56,3,0,3
CHI,2002-04-07,82,21,61,9,4,5
LAC,2001-11-04,3,0,3,3,0,3
LAC,2001-11-11,7,3,4,4,3,1
LAC,2001-11-18,10,5,5,3,2,1
LAC,2001-11-25,14,6,8,4,1,3
LAC,2001-12-02,17,8,9,3,2,1
LAC,2001-12-09,20,10,10,3,2,1
LAC,2001-12-16,24,13,11,4,3,1
LAC,2001-12-23,26,15,11,2,2,0
LAC,2001-12-30,29,15,14,3,0,3
LAC,2002-01-06,33,18,15,4,3,1
LAC,2002-01-13,38,19,19,5,1,4
LAC,2002-01-20,41,20,21,3,1,2
LAC,2002-01-27,44,22,22,3,2,1
LAC,2002-02-03,49,24,25,5,2,3
LAC,2002-02-17,53,26,27,4,2,2
LAC,2002-02-24,57,27,30,4,1,3
LAC,2002-03-03,60,30,30,3,3,0
LAC,2002-03-10,63,32,31,3,2,1
LAC,2002-03-17,67,34,33,4,2,2
LAC,2002-03-24,70,36,34,3,2,1
LAC,2002-03-31,74,37,37,4,1,3
LAC,2002-04-07,82,39,43,8,2,6
PHO,2001-11-04,4,1,3,4,1,3
PHO,2001-11-11,7,3,4,3,2,1
PHO,2001-11-18,11,5,6,4,2,2
PHO,2001-11-25,14,7,7,3,2,1
PHO,2001-12-02,18,11,7,4,4,0
PHO,2001-12-09,22,13,9,4,2,2
PHO,2001-12-16,25,14,11,3,1,2
PHO,2001-12-23,28,15,13,3,1,2
PHO,2001-12-30,31,18,13,3,3,0
PHO,2002-01-06,34,18,16,3,0,3
PHO,2002-01-13,38,19,19,4,1,3
PHO,2002-01-20,40,20,20,2,1,1
PHO,2002-01-27,43,21,22,3,1,2
PHO,2002-02-03,47,24,23,4,3,1
PHO,2002-02-17,52,25,27,5,1,4
PHO,2002-02-24,56,27,29,4,2,2
PHO,2002-03-03,59,28,31,3,1,2
PHO,2002-03-10,63,30,33,4,2,2
PHO,2002-03-17,67,30,37,4,0,4
PHO,2002-03-24,69,31,38,2,1,1
PHO,2002-03-31,73,34,39,4,3,1
PHO,2002-04-07,82,36,46,9,2,7
GSW,2001-11-04,4,2,2,4,2,2
GSW,2001-11-11,7,4,3,3,2,1
GSW,2001-11-18,11,6,5,4,2,2
GSW,2001-11-25,14,7,7,3,1,2
GSW,2001-12-02,17,7,10,3,0,3
GSW,2001-12-09,21,8,13,4,1,3
GSW,2001-12-16,25,9,16,4,1,3
GSW,2001-12-23,28,11,17,3,2,1
GSW,2001-12-30,30,12,18,2,1,1
GSW,2002-01-06,34,12,22,4,0,4
GSW,2002-01-13,35,12,23,1,0,1
GSW,2002-01-20,39,13,26,4,1,3
GSW,2002-01-27,42,14,28,3,1,2
GSW,2002-02-03,45,14,31,3,0,3
GSW,2002-02-17,49,15,34,4,1,3
GSW,2002-02-24,53,15,38,4,0,4
GSW,2002-03-03,57,16,41,4,1,3
GSW,2002-03-10,60,17,43,3,1,2
GSW,2002-03-17,64,17,47,4,0,4
GSW,2002-03-24,69,17,52,5,0,5
GSW,2002-03-31,73,18,55,4,1,3
GSW,2002-04-07,82,21,61,9,3,6
DAL,2001-11-04,4,3,1,4,3,1
DAL,2001-11-11,7,5,2,3,2,1
DAL,2001-11-18,10,6,4,3,1,2
DAL,2001-11-25,14,9,5,4,3,1
DAL,2001-12-02,18,12,6,4,3,1
DAL,2001-12-09,20,12,8,2,0,2
DAL,2001-12-16,24,15,9,4,3,1
DAL,2001-12-23,27,18,9,3,3,0
DAL,2001-12-30,30,21,9,3,3,0
DAL,2002-01-06,33,22,11,3,1,2
DAL,2002-01-13,36,25,11,3,3,0
DAL,2002-01-20,40,28,12,4,3,1
DAL,2002-01-27,44,32,12,4,4,0
DAL,2002-02-03,47,33,14,3,1,2
DAL,2002-02-17,53,37,16,6,4,2
DAL,2002-02-24,56,39,17,3,2,1
DAL,2002-03-03,59,41,18,3,2,1
DAL,2002-03-10,62,44,18,3,3,0
DAL,2002-03-17,66,46,20,4,2,2
DAL,2002-03-24,69,48,21,3,2,1
DAL,2002-03-31,73,51,22,4,3,1
DAL,2002-04-07,82,57,25,9,6,3
HOU,2001-11-04,4,3,1,4,3,1
HOU,2001-11-11,7,5,2,3,2,1
HOU,2001-11-18,10,6,4,3,1,2
HOU,2001-11-25,14,7,7,4,1,3
HOU,2001-12-02,17,7,10,3,0,3
HOU,2001-12-09,22,7,15,5,0,5
HOU,2001-12-16,25,7,18,3,0,3
HOU,2001-12-23,28,8,20,3,1,2
HOU,2001-12-30,31,9,22,3,1,2
HOU,2002-01-06,33,10,23,2,1,1
HOU,2002-01-13,36,12,24,3,2,1
HOU,2002-01-20,40,13,27,4,1,3
HOU,2002-01-27,44,14,30,4,1,3
HOU,2002-02-03,47,15,32,3,1,2
HOU,2002-02-17,51,17,34,4,2,2
HOU,2002-02-24,55,20,35,4,3,1
HOU,2002-03-03,58,21,37,3,1,2
HOU,2002-03-10,62,23,39,4,2,2
HOU,2002-03-17,65,25,40,3,2,1
HOU,2002-03-24,69,26,43,4,1,3
HOU,2002-03-31,72,26,46,3,0,3
HOU,2002-04-07,82,28,54,10,2,8
MIN,2001-11-04,3,3,0,3,3,0
MIN,2001-11-11,6,6,0,3,3,0
MIN,2001-11-18,9,8,1,3,2,1
MIN,2001-11-25,12,10,2,3,2,1
MIN,2001-12-02,15,10,5,3,0,3
MIN,2001-12-09,18,13,5,3,3,0
MIN,2001-12-16,22,16,6,4,3,1
MIN,2001-12-23,26,18,8,4,2,2
MIN,2001-12-30,29,20,9,3,2,1
MIN,2002-01-06,32,23,9,3,3,0
MIN,2002-01-13,36,27,9,4,4,0
MIN,2002-01-20,39,29,10,3,2,1
MIN,2002-01-27,43,31,12,4,2,2
MIN,2002-02-03,47,32,15,4,1,3
MIN,2002-02-17,52,35,17,5,3,2
MIN,2002-02-24,55,37,18,3,2,1
MIN,2002-03-03,59,40,19,4,3,1
MIN,2002-03-10,62,40,22,3,0,3
MIN,2002-03-17,66,40,26,4,0,4
MIN,2002-03-24,69,42,27,3,2,1
MIN,2002-03-31,73,45,28,4,3,1
MIN,2002-04-07,82,50,32,9,5,4
MEM,2001-11-04,3,0,3,3,0,3
MEM,2001-11-11,6,0,6,3,0,3
MEM,2001-11-18,9,1,8,3,1,2
MEM,2001-11-25,12,1,11,3,0,3
MEM,2001-12-02,16,4,12,4,3,1
MEM,2001-12-09,19,5,14,3,1,2
MEM,2001-12-16,23,5,18,4,0,4
MEM,2001-12-23,27,7,20,4,2,2
MEM,2001-12-30,30,9,21,3,2,1
MEM,2002-01-06,33,9,24,3,0,3
MEM,2002-01-13,36,12,24,3,3,0
MEM,2002-01-20,39,12,27,3,0,3
MEM,2002-01-27,43,12,31,4,0,4
MEM,2002-02-03,47,13,34,4,1,3
MEM,2002-02-17,52,15,37,5,2,3
MEM,2002-02-24,54,15,39,2,0,2
MEM,2002-03-03,59,15,44,5,0,5
MEM,2002-03-10,62,16,46,3,1,2
MEM,2002-03-17,66,17,49,4,1,3
MEM,2002-03-24,69,17,52,3,0,3
MEM,2002-03-31,72,19,53,3,2,1
MEM,2002-04-07,82,23,59,10,4,6
