team,date,count,win,loss,cur_count,cur_win,cur_loss
IND,2010-10-31,3,2,1,3,2,1
IND,2010-11-07,5,2,3,2,0,2
IND,2010-11-14,8,4,4,3,2,1
IND,2010-11-21,11,5,6,3,1,2
IND,2010-11-28,15,8,7,4,3,1
IND,2010-12-05,18,9,9,3,1,2
IND,2010-12-12,22,11,11,4,2,2
IND,2010-12-19,26,12,14,4,1,3
IND,2010-12-26,28,13,15,2,1,1
IND,2011-01-02,32,14,18,4,1,3
IND,2011-01-09,34,14,20,2,0,2
IND,2011-01-16,37,16,21,3,2,1
IND,2011-01-23,41,16,25,4,0,4
IND,2011-01-30,44,17,27,3,1,2
IND,2011-02-06,48,21,27,4,4,0
IND,2011-02-13,52,24,28,4,3,1
IND,2011-02-27,58,26,32,6,2,4
IND,2011-03-06,62,27,35,4,1,3
IND,2011-03-13,66,28,38,4,1,3
IND,2011-03-20,70,30,40,4,2,2
IND,2011-03-27,74,32,42,4,2,2
IND,2011-04-03,78,35,43,4,3,1
IND,2011-04-10,82,37,45,4,2,2
MIA,2010-10-31,4,3,1,4,3,1
MIA,2010-11-07,7,5,2,3,2,1
MIA,2010-11-14,10,6,4,3,1,2
MIA,2010-11-21,13,8,5,3,2,1
MIA,2010-11-28,17,9,8,4,1,3
MIA,2010-12-05,21,13,8,4,4,0
MIA,2010-12-12,25,17,8,4,4,0
MIA,2010-12-19,29,21,8,4,4,0
MIA,2010-12-26,32,23,9,3,2,1
MIA,2011-01-02,35,26,9,3,3,0
MIA,2011-01-09,39,30,9,4,4,0
MIA,2011-01-16,42,30,12,3,0,3
MIA,2011-01-23,44,31,13,2,1,1
MIA,2011-01-30,47,33,14,3,2,1
MIA,2011-02-06,51,37,14,4,4,0
MIA,2011-02-13,54,39,15,3,2,1
MIA,2011-02-27,60,43,17,6,4,2
MIA,2011-03-06,63,43,20,3,0,3
MIA,2011-03-13,66,45,21,3,2,1
MIA,2011-03-20,70,48,22,4,3,1
MIA,2011-03-27,73,51,22,3,3,0
MIA,2011-04-03,77,54,23,4,3,1
MIA,2011-04-10,82,58,24,5,4,1
NOH,2010-10-31,3,3,0,3,3,0
NOH,2010-11-07,6,6,0,3,3,0
NOH,2010-11-14,8,8,0,2,2,0
NOH,2010-11-21,12,11,1,4,3,1
NOH,2010-11-28,16,12,4,4,1,3
NOH,2010-12-05,20,13,7,4,1,3
NOH,2010-12-12,23,14,9,3,1,2
NOH,2010-12-19,27,16,11,4,2,2
NOH,2010-12-26,30,18,12,3,2,1
NOH,2011-01-02,34,20,14,4,2,2
NOH,2011-01-09,38,22,16,4,2,2
NOH,2011-01-16,41,25,16,3,3,0
NOH,2011-01-23,45,29,16,4,4,0
NOH,2011-01-30,49,31,18,4,2,2
NOH,2011-02-06,52,32,20,3,1,2
NOH,2011-02-13,56,33,23,4,1,3
NOH,2011-02-27,61,35,26,5,2,3
NOH,2011-03-06,65,37,28,4,2,2
NOH,2011-03-13,68,39,29,3,2,1
NOH,2011-03-20,71,40,31,3,1,2
NOH,2011-03-27,74,42,32,3,2,1
NOH,2011-04-03,77,44,33,3,2,1
NOH,2011-04-10,82,46,36,5,2,3
LAC,2010-10-31,3,0,3,3,0,3
LAC,2010-11-07,7,1,6,4,1,3
LAC,2010-11-14,10,1,9,3,0,3
LAC,2010-11-21,14,1,13,4,0,4
LAC,2010-11-28,18,3,15,4,2,2
LAC,2010-12-05,21,4,17,3,1,2
LAC,2010-12-12,25,5,20,4,1,3
LAC,2010-12-19,28,7,21,3,2,1
LAC,2010-12-26,31,9,22,3,2,1
LAC,2011-01-02,34,10,24,3,1,2
LAC,2011-01-09,36,12,24,2,2,0
LAC,2011-01-16,39,14,25,3,2,1
LAC,2011-01-23,43,17,26,4,3,1
LAC,2011-01-30,46,18,28,3,1,2
LAC,2011-02-06,50,19,31,4,1,3
LAC,2011-02-13,54,20,34,4,1,3
LAC,2011-02-27,60,21,39,6,1,5
LAC,2011-03-06,63,23,40,3,2,1
LAC,2011-03-13,67,26,41,4,3,1
LAC,2011-03-20,71,27,44,4,1,3
LAC,2011-03-27,74,29,45,3,2,1
LAC,2011-04-03,77,30,47,3,1,2
LAC,2011-04-10,82,32,50,5,2,3
NJN,2010-10-31,3,2,1,3,2,1
NJN,2010-11-07,6,2,4,3,0,3
NJN,2010-11-14,9,3,6,3,1,2
NJN,2010-11-21,13,4,9,4,1,3
NJN,2010-11-28,17,6,11,4,2,2
NJN,2010-12-05,21,6,15,4,0,4
NJN,2010-12-12,24,6,18,3,0,3
NJN,2010-12-19,28,8,20,4,2,2
NJN,2010-12-26,30,9,21,2,1,1
NJN,2011-01-02,34,9,25,4,0,4
NJN,2011-01-09,37,10,27,3,1,2
NJN,2011-01-16,40,10,30,3,0,3
NJN,2011-01-23,44,12,32,4,2,2
NJN,2011-01-30,48,14,34,4,2,2
NJN,2011-02-06,52,15,37,4,1,3
NJN,2011-02-13,55,17,38,3,2,1
NJN,2011-02-27,59,17,42,4,0,4
NJN,2011-03-06,62,19,43,3,2,1
NJN,2011-03-13,64,21,43,2,2,0
NJN,2011-03-20,68,22,46,4,1,3
NJN,2011-03-27,72,23,49,4,1,3
NJN,2011-04-03,76,23,53,4,0,4
NJN,2011-04-10,82,24,58,6,1,5
MIN,2010-10-31,3,1,2,3,1,2
MIN,2010-11-07,7,1,6,4,0,4
MIN,2010-11-14,11,3,8,4,2,2
MIN,2010-11-21,14,4,10,3,1,2
MIN,2010-11-28,17,4,13,3,0,3
MIN,2010-12-05,20,5,15,3,1,2
MIN,2010-12-12,24,6,18,4,1,3
MIN,2010-12-19,28,6,22,4,0,4
MIN,2010-12-26,31,7,24,3,1,2
MIN,2011-01-02,34,9,25,3,2,1
MIN,2011-01-09,38,9,29,4,0,4
MIN,2011-01-16,41,10,31,3,1,2
MIN,2011-01-23,43,10,33,2,0,2
MIN,2011-01-30,47,11,36,4,1,3
MIN,2011-02-06,50,11,39,3,0,3
MIN,2011-02-13,54,13,41,4,2,2
MIN,2011-02-27,60,14,46,6,1,5
MIN,2011-03-06,64,15,49,4,1,3
MIN,2011-03-13,68,17,51,4,2,2
MIN,2011-03-20,71,17,54,3,0,3
MIN,2011-03-27,74,17,57,3,0,3
MIN,2011-04-03,77,17,60,3,0,3
MIN,2011-04-10,82,17,65,5,0,5
DET,2010-10-31,3,0,3,3,0,3
DET,2010-11-07,7,2,5,4,2,2
DET,2010-11-14,10,4,6,3,2,1
DET,2010-11-21,13,5,8,3,1,2
DET,2010-11-28,17,6,11,4,1,3
DET,2010-12-05,21,7,14,4,1,3
DET,2010-12-12,25,7,18,4,0,4
DET,2010-12-19,28,9,19,3,2,1
DET,2010-12-26,30,10,20,2,1,1
DET,2011-01-02,33,11,22,3,1,2
DET,2011-01-09,36,12,24,3,1,2
DET,2011-01-16,40,14,26,4,2,2
DET,2011-01-23,44,16,28,4,2,2
DET,2011-01-30,48,17,31,4,1,3
DET,2011-02-06,51,19,32,3,2,1
DET,2011-02-13,55,20,35,4,1,3
DET,2011-02-27,61,22,39,6,2,4
DET,2011-03-06,64,23,41,3,1,2
DET,2011-03-13,67,23,44,3,0,3
DET,2011-03-20,70,25,45,3,2,1
DET,2011-03-27,73,26,47,3,1,2
DET,2011-04-03,76,26,50,3,0,3
DET,2011-04-10,82,30,52,6,4,2
DEN,2010-10-31,3,2,1,3,2,1
DEN,2010-11-07,6,4,2,3,2,1
DEN,2010-11-14,9,5,4,3,1,2
DEN,2010-11-21,13,7,6,4,2,2
DEN,2010-11-28,16,10,6,3,3,0
DEN,2010-12-05,19,13,6,3,3,0
DEN,2010-12-12,23,14,9,4,1,3
DEN,2010-12-19,26,16,10,3,2,1
DEN,2010-12-26,29,16,13,3,0,3
DEN,2011-01-02,32,19,13,3,3,0
DEN,2011-01-09,36,20,16,4,1,3
DEN,2011-01-16,40,23,17,4,3,1
DEN,2011-01-23,43,25,18,3,2,1
DEN,2011-01-30,47,28,19,4,3,1
DEN,2011-02-06,51,30,21,4,2,2
DEN,2011-02-13,55,31,24,4,1,3
DEN,2011-02-27,60,34,26,5,3,2
DEN,2011-03-06,64,37,27,4,3,1
DEN,2011-03-13,66,39,27,2,2,0
DEN,2011-03-20,70,41,29,4,2,2
DEN,2011-03-27,73,44,29,3,3,0
DEN,2011-04-03,76,47,29,3,3,0
DEN,2011-04-10,82,50,32,6,3,3
GSW,2010-10-31,3,2,1,3,2,1
GSW,2010-11-07,6,4,2,3,2,1
GSW,2010-11-14,10,6,4,4,2,2
GSW,2010-11-21,13,7,6,3,1,2
GSW,2010-11-28,17,8,9,4,1,3
GSW,2010-12-05,20,8,12,3,0,3
GSW,2010-12-12,23,8,15,3,0,3
GSW,2010-12-19,26,9,17,3,1,2
GSW,2010-12-26,29,11,18,3,2,1
GSW,2011-01-02,33,13,20,4,2,2
GSW,2011-01-09,37,15,22,4,2,2
GSW,2011-01-16,39,16,23,2,1,1
GSW,2011-01-23,43,19,24,4,3,1
GSW,2011-01-30,47,20,27,4,1,3
GSW,2011-02-06,49,22,27,2,2,0
GSW,2011-02-13,53,24,29,4,2,2
GSW,2011-02-27,58,26,32,5,2,3
GSW,2011-03-06,62,27,35,4,1,3
GSW,2011-03-13,66,30,36,4,3,1
GSW,2011-03-20,70,30,40,4,0,4
GSW,2011-03-27,74,32,42,4,2,2
GSW,2011-04-03,77,33,44,3,1,2
GSW,2011-04-10,82,36,46,5,3,2
MIL,2010-10-31,3,1,2,3,1,2
MIL,2010-11-07,7,2,5,4,1,3
MIL,2010-11-14,10,5,5,3,3,0
MIL,2010-11-21,13,5,8,3,0,3
MIL,2010-11-28,16,6,10,3,1,2
MIL,2010-12-05,19,7,12,3,1,2
MIL,2010-12-12,22,9,13,3,2,1
MIL,2010-12-19,25,10,15,3,1,2
MIL,2010-12-26,28,12,16,3,2,1
MIL,2011-01-02,31,13,18,3,1,2
MIL,2011-01-09,35,14,21,4,1,3
MIL,2011-01-16,37,14,23,2,0,2
MIL,2011-01-23,41,16,25,4,2,2
MIL,2011-01-30,45,19,26,4,3,1
MIL,2011-02-06,49,19,30,4,0,4
MIL,2011-02-13,53,20,33,4,1,3
MIL,2011-02-27,58,22,36,5,2,3
MIL,2011-03-06,61,23,38,3,1,2
MIL,2011-03-13,65,26,39,4,3,1
MIL,2011-03-20,69,28,41,4,2,2
MIL,2011-03-27,72,29,43,3,1,2
MIL,2011-04-03,76,31,45,4,2,2
MIL,2011-04-10,82,35,47,6,4,2
SAC,2010-10-31,3,2,1,3,2,1
SAC,2010-11-07,6,3,3,3,1,2
SAC,2010-11-14,9,3,6,3,0,3
SAC,2010-11-21,12,4,8,3,1,2
SAC,2010-11-28,15,4,11,3,0,3
SAC,2010-12-05,18,4,14,3,0,3
SAC,2010-12-12,21,5,16,3,1,2
SAC,2010-12-19,25,5,20,4,0,4
SAC,2010-12-26,27,5,22,2,0,2
SAC,2011-01-02,31,7,24,4,2,2
SAC,2011-01-09,34,8,26,3,1,2
SAC,2011-01-16,38,9,29,4,1,3
SAC,2011-01-23,41,9,32,3,0,3
SAC,2011-01-30,45,12,33,4,3,1
SAC,2011-02-06,47,12,35,2,0,2
SAC,2011-02-13,51,13,38,4,1,3
SAC,2011-02-27,57,14,43,6,1,5
SAC,2011-03-06,60,15,45,3,1,2
SAC,2011-03-13,64,15,49,4,0,4
SAC,2011-03-20,68,17,51,4,2,2
SAC,2011-03-27,72,20,52,4,3,1
SAC,2011-04-03,76,22,54,4,2,2
SAC,2011-04-10,82,24,58,6,2,4
LAL,2010-10-31,3,3,0,3,3,0
LAL,2010-11-07,7,7,0,4,4,0
LAL,2010-11-14,10,8,2,3,1,2
LAL,2010-11-21,14,12,2,4,4,0
LAL,2010-11-28,17,13,4,3,1,2
LAL,2010-12-05,20,14,6,3,1,2
LAL,2010-12-12,24,17,7,4,3,1
LAL,2010-12-19,28,21,7,4,4,0
LAL,2010-12-26,30,21,9,2,0,2
LAL,2011-01-02,34,23,11,4,2,2
LAL,2011-01-09,38,27,11,4,4,0
LAL,2011-01-16,42,30,12,4,3,1
LAL,2011-01-23,45,32,13,3,2,1
LAL,2011-01-30,48,33,15,3,1,2
LAL,2011-02-06,51,35,16,3,2,1
LAL,2011-02-13,55,38,17,4,3,1
LAL,2011-02-27,61,42,19,6,4,2
LAL,2011-03-06,64,45,19,3,3,0
LAL,2011-03-13,67,47,20,3,2,1
LAL,2011-03-20,70,50,20,3,3,0
LAL,2011-03-27,73,53,20,3,3,0
LAL,2011-04-03,76,55,21,3,2,1
LAL,2011-04-10,82,57,25,6,2,4
SAS,2010-10-31,2,1,1,2,1,1
SAS,2010-11-07,5,4,1,3,3,0
SAS,2010-11-14,9,8,1,4,4,0
SAS,2010-11-21,12,11,1,3,3,0
SAS,2010-11-28,16,14,2,4,3,1
SAS,2010-12-05,20,17,3,4,3,1
SAS,2010-12-12,23,20,3,3,3,0
SAS,2010-12-19,26,23,3,3,3,0
SAS,2010-12-26,30,26,4,4,3,1
SAS,2011-01-02,33,29,4,3,3,0
SAS,2011-01-09,37,31,6,4,2,2
SAS,2011-01-16,41,35,6,4,4,0
SAS,2011-01-23,44,37,7,3,2,1
SAS,2011-01-30,47,40,7,3,3,0
SAS,2011-02-06,50,42,8,3,2,1
SAS,2011-02-13,54,45,9,4,3,1
SAS,2011-02-27,59,49,10,5,4,1
SAS,2011-03-06,63,51,12,4,2,2
SAS,2011-03-13,66,54,12,3,3,0
SAS,2011-03-20,69,56,13,3,2,1
SAS,2011-03-27,73,57,16,4,1,3
SAS,2011-04-03,77,58,19,4,1,3
SAS,2011-04-10,82,61,21,5,3,2
NYK,2010-10-31,3,1,2,3,1,2
NYK,2010-11-07,6,3,3,3,2,1
NYK,2010-11-14,10,3,7,4,0,4
NYK,2010-11-21,14,6,8,4,3,1
NYK,2010-11-28,18,9,9,4,3,1
NYK,2010-12-05,21,12,9,3,3,0
NYK,2010-12-12,25,16,9,4,4,0
NYK,2010-12-19,28,16,12,3,0,3
NYK,2010-12-26,30,18,12,2,2,0
NYK,2011-01-02,33,19,14,3,1,2
NYK,2011-01-09,36,21,15,3,2,1
NYK,2011-01-16,39,22,17,3,1,2
NYK,2011-01-23,43,22,21,4,0,4
NYK,2011-01-30,47,25,22,4,3,1
NYK,2011-02-06,50,26,24,3,1,2
NYK,2011-02-13,53,27,26,3,1,2
NYK,2011-02-27,57,30,27,4,3,1
NYK,2011-03-06,61,32,29,4,2,2
NYK,2011-03-13,65,34,31,4,2,2
NYK,2011-03-20,69,35,34,4,1,3
NYK,2011-03-27,73,35,38,4,0,4
NYK,2011-04-03,76,38,38,3,3,0
NYK,2011-04-10,82,42,40,6,4,2
ORL,2010-10-31,2,1,1,2,1,1
ORL,2010-11-07,5,4,1,3,3,0
ORL,2010-11-14,9,6,3,4,2,2
ORL,2010-11-21,12,9,3,3,3,0
ORL,2010-11-28,16,12,4,4,3,1
ORL,2010-12-05,20,15,5,4,3,1
ORL,2010-12-12,24,16,8,4,1,3
ORL,2010-12-19,26,16,10,2,0,2
ORL,2010-12-26,30,18,12,4,2,2
ORL,2011-01-02,33,21,12,3,3,0
ORL,2011-01-09,37,25,12,4,4,0
ORL,2011-01-16,40,26,14,3,1,2
ORL,2011-01-23,44,29,15,4,3,1
ORL,2011-01-30,48,31,17,4,2,2
ORL,2011-02-06,52,32,20,4,1,3
ORL,2011-02-13,56,35,21,4,3,1
ORL,2011-02-27,60,38,22,4,3,1
ORL,2011-03-06,63,40,23,3,2,1
ORL,2011-03-13,67,42,25,4,2,2
ORL,2011-03-20,70,44,26,3,2,1
ORL,2011-03-27,73,47,26,3,3,0
ORL,2011-04-03,77,48,29,4,1,3
ORL,2011-04-10,82,52,30,5,4,1
OKC,2010-10-31,3,2,1,3,2,1
OKC,2010-11-07,6,3,3,3,1,2
OKC,2010-11-14,9,5,4,3,2,1
OKC,2010-11-21,13,9,4,4,4,0
OKC,2010-11-28,17,11,6,4,2,2
OKC,2010-12-05,21,14,7,4,3,1
OKC,2010-12-12,25,17,8,4,3,1
OKC,2010-12-19,28,19,9,3,2,1
OKC,2010-12-26,31,21,10,3,2,1
OKC,2011-01-02,35,23,12,4,2,2
OKC,2011-01-09,38,25,13,3,2,1
OKC,2011-01-16,40,27,13,2,2,0
OKC,2011-01-23,43,28,15,3,1,2
OKC,2011-01-30,47,30,17,4,2,2
OKC,2011-02-06,50,33,17,3,3,0
OKC,2011-02-13,53,34,19,3,1,2
OKC,2011-02-27,58,36,22,5,2,3
OKC,2011-03-06,61,39,22,3,3,0
OKC,2011-03-13,65,42,23,4,3,1
OKC,2011-03-20,69,45,24,4,3,1
OKC,2011-03-27,72,48,24,3,3,0
OKC,2011-04-03,76,50,26,4,2,2
OKC,2011-04-10,82,55,27,6,5,1
MEM,2010-10-31,3,2,1,3,2,1
MEM,2010-11-07,7,3,4,4,1,3
MEM,2010-11-14,10,4,6,3,1,2
MEM,2010-11-21,14,5,9,4,1,3
MEM,2010-11-28,17,7,10,3,2,1
MEM,2010-12-05,21,8,13,4,1,3
MEM,2010-12-12,24,10,14,3,2,1
MEM,2010-12-19,28,12,16,4,2,2
MEM,2010-12-26,30,13,17,2,1,1
MEM,2011-01-02,34,15,19,4,2,2
MEM,2011-01-09,37,17,20,3,2,1
MEM,2011-01-16,40,19,21,3,2,1
MEM,2011-01-23,44,21,23,4,2,2
MEM,2011-01-30,48,24,24,4,3,1
MEM,2011-02-06,52,27,25,4,3,1
MEM,2011-02-13,56,30,26,4,3,1
MEM,2011-02-27,61,33,28,5,3,2
MEM,2011-03-06,64,35,29,3,2,1
MEM,2011-03-13,67,36,31,3,1,2
MEM,2011-03-20,70,38,32,3,2,1
MEM,2011-03-27,74,41,33,4,3,1
MEM,2011-04-03,77,44,33,3,3,0
MEM,2011-04-10,82,46,36,5,2,3
CHA,2010-10-31,3,0,3,3,0,3
CHA,2010-11-07,6,1,5,3,1,2
CHA,2010-11-14,10,3,7,4,2,2
CHA,2010-11-21,13,5,8,3,2,1
CHA,2010-11-28,17,6,11,4,1,3
CHA,2010-12-05,20,7,13,3,1,2
CHA,2010-12-12,23,8,15,3,1,2
CHA,2010-12-19,26,9,17,3,1,2
CHA,2010-12-26,28,9,19,2,0,2
CHA,2011-01-02,31,11,20,3,2,1
CHA,2011-01-09,34,13,21,3,2,1
CHA,2011-01-16,38,15,23,4,2,2
CHA,2011-01-23,42,17,25,4,2,2
CHA,2011-01-30,46,20,26,4,3,1
CHA,2011-02-06,50,21,29,4,1,3
CHA,2011-02-13,54,23,31,4,2,2
CHA,2011-02-27,59,26,33,5,3,2
CHA,2011-03-06,62,26,36,3,0,3
CHA,2011-03-13,66,28,38,4,2,2
CHA,2011-03-20,69,28,41,3,0,3
CHA,2011-03-27,72,30,42,3,2,1
CHA,2011-04-03,76,32,44,4,2,2
CHA,2011-04-10,82,34,48,6,2,4
CLE,2010-10-31,3,1,2,3,1,2
CLE,2010-11-07,6,3,3,3,2,1
CLE,2010-11-14,9,4,5,3,1,2
CLE,2010-11-21,12,5,7,3,1,2
CLE,2010-11-28,16,7,9,4,2,2
CLE,2010-12-05,20,7,13,4,0,4
CLE,2010-12-12,24,7,17,4,0,4
CLE,2010-12-19,27,8,19,3,1,2
CLE,2010-12-26,30,8,22,3,0,3
CLE,2011-01-02,34,8,26,4,0,4
CLE,2011-01-09,37,8,29,3,0,3
CLE,2011-01-16,40,8,32,3,0,3
CLE,2011-01-23,43,8,35,3,0,3
CLE,2011-01-30,47,8,39,4,0,4
CLE,2011-02-06,51,8,43,4,0,4
CLE,2011-02-13,55,9,46,4,1,3
CLE,2011-02-27,59,11,48,4,2,2
CLE,2011-03-06,62,12,50,3,1,2
CLE,2011-03-13,65,12,53,3,0,3
CLE,2011-03-20,68,13,55,3,1,2
CLE,2011-03-27,72,14,58,4,1,3
CLE,2011-04-03,76,15,61,4,1,3
CLE,2011-04-10,82,19,63,6,4,2
HOU,2010-10-31,3,0,3,3,0,3
HOU,2010-11-07,6,1,5,3,1,2
HOU,2010-11-14,9,3,6,3,2,1
HOU,2010-11-21,12,3,9,3,0,3
HOU,2010-11-28,16,5,11,4,2,2
HOU,2010-12-05,20,7,13,4,2,2
HOU,2010-12-12,23,9,14,3,2,1
HOU,2010-12-19,27,12,15,4,3,1
HOU,2010-12-26,29,14,15,2,2,0
HOU,2011-01-02,33,16,17,4,2,2
HOU,2011-01-09,37,16,21,4,0,4
HOU,2011-01-16,41,18,23,4,2,2
HOU,2011-01-23,45,20,25,4,2,2
HOU,2011-01-30,49,22,27,4,2,2
HOU,2011-02-06,52,24,28,3,2,1
HOU,2011-02-13,55,25,30,3,1,2
HOU,2011-02-27,61,30,31,6,5,1
HOU,2011-03-06,64,32,32,3,2,1
HOU,2011-03-13,67,33,34,3,1,2
HOU,2011-03-20,71,37,34,4,4,0
HOU,2011-03-27,73,38,35,2,1,1
HOU,2011-04-03,77,41,36,4,3,1
HOU,2011-04-10,82,43,39,5,2,3
UTA,2010-10-31,3,1,2,3,1,2
UTA,2010-11-07,6,3,3,3,2,1
UTA,2010-11-14,10,7,3,4,4,0
UTA,2010-11-21,14,9,5,4,2,2
UTA,2010-11-28,18,13,5,4,4,0
UTA,2010-12-05,21,15,6,3,2,1
UTA,2010-12-12,25,17,8,4,2,2
UTA,2010-12-19,28,19,9,3,2,1
UTA,2010-12-26,30,21,9,2,2,0
UTA,2011-01-02,34,23,11,4,2,2
UTA,2011-01-09,38,25,13,4,2,2
UTA,2011-01-16,40,27,13,2,2,0
UTA,2011-01-23,44,27,17,4,0,4
UTA,2011-01-30,48,28,20,4,1,3
UTA,2011-02-06,52,30,22,4,2,2
UTA,2011-02-13,55,31,24,3,1,2
UTA,2011-02-27,60,32,28,5,1,4
UTA,2011-03-06,63,33,30,3,1,2
UTA,2011-03-13,67,34,33,4,1,3
UTA,2011-03-20,70,36,34,3,2,1
UTA,2011-03-27,74,36,38,4,0,4
UTA,2011-04-03,77,36,41,3,0,3
UTA,2011-04-10,82,39,43,5,3,2
DAL,2010-10-31,3,2,1,3,2,1
DAL,2010-11-07,5,3,2,2,1,1
DAL,2010-11-14,8,6,2,3,3,0
DAL,2010-11-21,12,8,4,4,2,2
DAL,2010-11-28,16,12,4,4,4,0
DAL,2010-12-05,20,16,4,4,4,0
DAL,2010-12-12,23,19,4,3,3,0
DAL,2010-12-19,26,21,5,3,2,1
DAL,2010-12-26,28,23,5,2,2,0
DAL,2011-01-02,33,25,8,5,2,3
DAL,2011-01-09,36,26,10,3,1,2
DAL,2011-01-16,39,26,13,3,0,3
DAL,2011-01-23,43,28,15,4,2,2
DAL,2011-01-30,46,31,15,3,3,0
DAL,2011-02-06,50,35,15,4,4,0
DAL,2011-02-13,54,38,16,4,3,1
DAL,2011-02-27,59,43,16,5,5,0
DAL,2011-03-06,62,45,17,3,2,1
DAL,2011-03-13,66,47,19,4,2,2
DAL,2011-03-20,70,49,21,4,2,2
DAL,2011-03-27,73,52,21,3,3,0
DAL,2011-04-03,77,53,24,4,1,3
DAL,2011-04-10,82,57,25,5,4,1
ATL,2010-10-31,3,3,0,3,3,0
ATL,2010-11-07,7,6,1,4,3,1
ATL,2010-11-14,11,7,4,4,1,3
ATL,2010-11-21,13,8,5,2,1,1
ATL,2010-11-28,18,11,7,5,3,2
ATL,2010-12-05,21,13,8,3,2,1
ATL,2010-12-12,25,16,9,4,3,1
ATL,2010-12-19,29,17,12,4,1,3
ATL,2010-12-26,32,19,13,3,2,1
ATL,2011-01-02,36,22,14,4,3,1
ATL,2011-01-09,39,25,14,3,3,0
ATL,2011-01-16,41,26,15,2,1,1
ATL,2011-01-23,45,29,16,4,3,1
ATL,2011-01-30,48,30,18,3,1,2
ATL,2011-02-06,51,33,18,3,3,0
ATL,2011-02-13,53,33,20,2,0,2
ATL,2011-02-27,59,36,23,6,3,3
ATL,2011-03-06,63,37,26,4,1,3
ATL,2011-03-13,66,38,28,3,1,2
ATL,2011-03-20,70,40,30,4,2,2
ATL,2011-03-27,74,42,32,4,2,2
ATL,2011-04-03,77,44,33,3,2,1
ATL,2011-04-10,82,44,38,5,0,5
CHI,2010-10-31,2,1,1,2,1,1
CHI,2010-11-07,5,2,3,3,1,2
CHI,2010-11-14,8,5,3,3,3,0
CHI,2010-11-21,11,7,4,3,2,1
CHI,2010-11-28,15,9,6,4,2,2
CHI,2010-12-05,18,10,8,3,1,2
CHI,2010-12-12,22,14,8,4,4,0
CHI,2010-12-19,25,16,9,3,2,1
CHI,2010-12-26,29,19,10,4,3,1
CHI,2011-01-02,32,22,10,3,3,0
CHI,2011-01-09,36,24,12,4,2,2
CHI,2011-01-16,40,27,13,4,3,1
CHI,2011-01-23,44,30,14,4,3,1
CHI,2011-01-30,47,33,14,3,3,0
CHI,2011-02-06,49,34,15,2,1,1
CHI,2011-02-13,52,36,16,3,2,1
CHI,2011-02-27,57,40,17,5,4,1
CHI,2011-03-06,61,43,18,4,3,1
CHI,2011-03-13,65,47,18,4,4,0
CHI,2011-03-20,68,49,19,3,2,1
CHI,2011-03-27,72,53,19,4,4,0
CHI,2011-04-03,76,56,20,4,3,1
CHI,2011-04-10,82,62,20,6,6,0
BOS,2010-10-31,3,2,1,3,2,1
BOS,2010-11-07,7,6,1,4,4,0
BOS,2010-11-14,10,8,2,3,2,1
BOS,2010-11-21,13,9,4,3,1,2
BOS,2010-11-28,16,12,4,3,3,0
BOS,2010-12-05,20,16,4,4,4,0
BOS,2010-12-12,23,19,4,3,3,0
BOS,2010-12-19,26,22,4,3,3,0
BOS,2010-12-26,28,23,5,2,1,1
BOS,2011-01-02,32,25,7,4,2,2
BOS,2011-01-09,36,28,8,4,3,1
BOS,2011-01-16,39,30,9,3,2,1
BOS,2011-01-23,43,33,10,4,3,1
BOS,2011-01-30,47,36,11,4,3,1
BOS,2011-02-06,50,38,12,3,2,1
BOS,2011-02-13,53,39,14,3,1,2
BOS,2011-02-27,57,42,15,4,3,1
BOS,2011-03-06,61,46,15,4,4,0
BOS,2011-03-13,64,47,17,3,1,2
BOS,2011-03-20,68,49,19,4,2,2
BOS,2011-03-27,72,51,21,4,2,2
BOS,2011-04-03,76,53,23,4,2,2
BOS,2011-04-10,82,56,26,6,3,3
PHO,2010-10-31,3,1,2,3,1,2
PHO,2010-11-07,6,3,3,3,2,1
PHO,2010-11-14,9,5,4,3,2,1
PHO,2010-11-21,13,6,7,4,1,3
PHO,2010-11-28,17,8,9,4,2,2
PHO,2010-12-05,20,11,9,3,3,0
PHO,2010-12-12,23,11,12,3,0,3
PHO,2010-12-19,26,13,13,3,2,1
PHO,2010-12-26,29,13,16,3,0,3
PHO,2011-01-02,32,14,18,3,1,2
PHO,2011-01-09,35,15,20,3,1,2
PHO,2011-01-16,38,17,21,3,2,1
PHO,2011-01-23,42,20,22,4,3,1
PHO,2011-01-30,46,22,24,4,2,2
PHO,2011-02-06,48,23,25,2,1,1
PHO,2011-02-13,52,26,26,4,3,1
PHO,2011-02-27,57,30,27,5,4,1
PHO,2011-03-06,61,32,29,4,2,2
PHO,2011-03-13,64,33,31,3,1,2
PHO,2011-03-20,68,35,33,4,2,2
PHO,2011-03-27,72,36,36,4,1,3
PHO,2011-04-03,76,37,39,4,1,3
PHO,2011-04-10,82,40,42,6,3,3
TOR,2010-10-31,2,1,1,2,1,1
TOR,2010-11-07,6,1,5,4,0,4
TOR,2010-11-14,10,2,8,4,1,3
TOR,2010-11-21,14,5,9,4,3,1
TOR,2010-11-28,17,6,11,3,1,2
TOR,2010-12-05,20,8,12,3,2,1
TOR,2010-12-12,24,9,15,4,1,3
TOR,2010-12-19,28,10,18,4,1,3
TOR,2010-12-26,29,10,19,1,0,1
TOR,2011-01-02,33,11,22,4,1,3
TOR,2011-01-09,37,13,24,4,2,2
TOR,2011-01-16,40,13,27,3,0,3
TOR,2011-01-23,44,13,31,4,0,4
TOR,2011-01-30,48,13,35,4,0,4
TOR,2011-02-06,51,14,37,3,1,2
TOR,2011-02-13,55,15,40,4,1,3
TOR,2011-02-27,60,16,44,5,1,4
TOR,2011-03-06,63,17,46,3,1,2
TOR,2011-03-13,66,18,48,3,1,2
TOR,2011-03-20,69,20,49,3,2,1
TOR,2011-03-27,73,20,53,4,0,4
TOR,2011-04-03,76,21,55,3,1,2
TOR,2011-04-10,82,22,60,6,1,5
PHI,2010-10-31,3,0,3,3,0,3
PHI,2010-11-07,7,2,5,4,2,2
PHI,2010-11-14,10,2,8,3,0,3
PHI,2010-11-21,13,3,10,3,1,2
PHI,2010-11-28,17,4,13,4,1,3
PHI,2010-12-05,20,6,14,3,2,1
PHI,2010-12-12,23,8,15,3,2,1
PHI,2010-12-19,27,11,16,4,3,1
PHI,2010-12-26,30,12,18,3,1,2
PHI,2011-01-02,33,13,20,3,1,2
PHI,2011-01-09,37,15,22,4,2,2
PHI,2011-01-16,39,16,23,2,1,1
PHI,2011-01-23,43,18,25,4,2,2
PHI,2011-01-30,47,21,26,4,3,1
PHI,2011-02-06,50,23,27,3,2,1
PHI,2011-02-13,54,26,28,4,3,1
PHI,2011-02-27,59,30,29,5,4,1
PHI,2011-03-06,62,32,30,3,2,1
PHI,2011-03-13,66,34,32,4,2,2
PHI,2011-03-20,70,36,34,4,2,2
PHI,2011-03-27,73,37,36,3,1,2
PHI,2011-04-03,77,40,37,4,3,1
PHI,2011-04-10,82,41,41,5,1,4
POR,2010-10-31,3,3,0,3,3,0
POR,2010-11-07,8,5,3,5,2,3
POR,2010-11-14,11,6,5,3,1,2
POR,2010-11-21,14,8,6,3,2,1
POR,2010-11-28,16,8,8,2,0,2
POR,2010-12-05,20,9,11,4,1,3
POR,2010-12-12,24,12,12,4,3,1
POR,2010-12-19,28,14,14,4,2,2
POR,2010-12-26,30,15,15,2,1,1
POR,2011-01-02,34,18,16,4,3,1
POR,2011-01-09,38,20,18,4,2,2
POR,2011-01-16,41,21,20,3,1,2
POR,2011-01-23,45,25,20,4,4,0
POR,2011-01-30,47,25,22,2,0,2
POR,2011-02-06,51,27,24,4,2,2
POR,2011-02-13,54,30,24,3,3,0
POR,2011-02-27,59,33,26,5,3,2
POR,2011-03-06,62,35,27,3,2,1
POR,2011-03-13,66,37,29,4,2,2
POR,2011-03-20,70,40,30,4,3,1
POR,2011-03-27,73,42,31,3,2,1
POR,2011-04-03,77,45,32,4,3,1
POR,2011-04-10,82,48,34,5,3,2
WAS,2010-10-31,2,0,2,2,0,2
WAS,2010-11-07,5,1,4,3,1,2
WAS,2010-11-14,8,2,6,3,1,2
WAS,2010-11-21,12,4,8,4,2,2
WAS,2010-11-28,15,5,10,3,1,2
WAS,2010-12-05,19,6,13,4,1,3
WAS,2010-12-12,22,6,16,3,0,3
WAS,2010-12-19,25,6,19,3,0,3
WAS,2010-12-26,28,7,21,3,1,2
WAS,2011-01-02,32,8,24,4,1,3
WAS,2011-01-09,35,9,26,3,1,2
WAS,2011-01-16,38,11,27,3,2,1
WAS,2011-01-23,42,13,29,4,2,2
WAS,2011-01-30,46,13,33,4,0,4
WAS,2011-02-06,50,13,37,4,0,4
WAS,2011-02-13,53,15,38,3,2,1
WAS,2011-02-27,58,15,43,5,0,5
WAS,2011-03-06,62,16,46,4,1,3
WAS,2011-03-13,64,16,48,2,0,2
WAS,2011-03-20,68,17,51,4,1,3
WAS,2011-03-27,72,17,55,4,0,4
WAS,2011-04-03,76,20,56,4,3,1
WAS,2011-04-10,82,23,59,6,3,3
